111111111
1P01C1E01
110101101
1001000011
11C0C0101
111111111