111111111
1P01C1E01
110101101
10010X001
11C0C0101
111111111