111111111
1P0101E01
110101101
100100001
110000101
111111111