1111111111111111111111111111111111
1XQXQ000000000000000000000000000E1
1XX1111111111000011111111111110001
1001000000000000000000010000000001
10010000C00000C000000XX10000000001
1XX11111110000C0000000010000000001
100100000XX000C001Q0000100X00X0001
1001000000000000010000010000000001
1001111111111010001111100000000001
1Q000000Q0000000X0000000000000X001
100CCC0000XX0000000000000000CC0001
10X000000000000000X000000C00000001
10X000000000C000000000000000000001
1C0000Q111111111000000000000000001
1CQ000011Q000000000000000000XXXX01
1XXXXXXX10000000000C00000000000001
111111111XXX0000000C0000000XX00001
1P0000000000000000000XX000C00C0001
1111111111111111111111111111111111