1111111111111111111111111111111111
10000000000000000000000000000000E1
1001111111111000011111111111110001
1001000000000000000000010000000001
10010000C00000C0000000010000000001
10011111110000C0000000010000000001
10010000000000C0010000010000000001
1001000000000000010000010000000001
1001111111111010001111100000000001
1000000000000000000000000000000001
100CCC0000000000000000000000CC0001
1000000000000000000000000C00000001
100000000000C000000000000000000001
1C00000111111111000000000000000001
1C00000110000000000000000000000001
1000000010000000000C00000000000001
1111111110000000000C00000000000001
1P000000000000000000000000C00C0001
1111111111111111111111111111111111