11111111
1P111E11
10111011
10110011
1001C101
1100C101
1111C101
1111C101
1111C101
1111C101
1111C101
11111111