1111111
1P00001
1010101
1010101
1C1E1C1
1111111